############
#..........#
#.....@....#
#...###....#
#..........#
#...s......#
############