#############
#.......s...#
#...........#
#...####.@..#
#############